a b O O O O O O O O O O O O O O O O O O O
O O O O O O O O O O O O O O O O O O O O O
O O O O O O O O O O O O O O O O O O O O O
O O O O O O c c c O O O O O O O O e O O O
O O O O O O O O O O O O O O O O O O O O O
O O O O O O O O O B O C O O O O O O O O O
O O O O O O O O O O O O O O O O O O O O O
O O O e O O O O O O O O O O O O O O O O O
O O O d e O O O O O O O O O O O O O O O O
O O O O O O O O O O O O O O O O e O O O O
O O O O O O O O O O O O O O O O O O O O b