O O O O O O O O O O O O O O O O O O O O O
O O a O O O b b O O O O O O O O O O O O O
O O O O O O O O O O O O O O O O O O O O O
O O O O O O O O O O O O O O O O O O O O O
O O O O O O O b O O O O O O O O c O O O O
O O O O O O O b O O D O O O O O c O O O O
O O O O O O O O O O O O O O O O c O O O O
O O O O O O O O O O O O O O O O c O O O O
b O O O O O O O O O O O O O O O O O O O O
b b O O O O O O O O O O O O O O O O O O O
b b b O O O O O O O O O O O O O O O O O O