O O O O O O O O O O O O O O O O O O O O O
O O O O O O b b O O O O O O O O O O O O O
O O O O O O O O O O O O O O O O O O O O O
O O O O O O O b O O O O O O O O O O O O O
O O O O O O O b O O O O O O O O a O O O O
O O O O O O O b O O A O O O O O a O O O O
O O O O O O O O O O O O O O O O a O O O O
O O O O O O O O O O O O O O O O a O O O O
b O O O O O O O O O O O O O O O O O O O O
b b O O O O O O O O O O O O O O O O O O O
b b b O O O O O O O O O O O O O O O O O O