O O O O O O O O O O O O O O O O O O O O O
O O O O O O O O O O O O O O O O O O O O O
O O . O O O O O O O O O O O O O O O . O O
O O O O O O O O O O O O O O O O O O O O O
d O O O O O O O O O O O O O e O O O O O e
d d O O O O e O O O O O O O O O O O O O O
O d O O O O O O O O O O O O O O O O O O e
O O O O O O O O O O O O O O O O O O O O O
O O 7 O O 3 O O O O O 3 O O O O O O . O O
O O O O O O O O O e e O O O O e O O O O O
O O O O O O d d d e d O O O e O O O O O O