1 a O O O O O O O O O O O O O O a a a a 1
a a O O O O O O O O O O O O O O O O O O a
O O . O O P O O O O O O O O p O O O . O a
O O O O O O O O O O O O O O O O O O O O O
O O O O O O O O O O O O O O O O O O O O O
O O O O O O O O O O d O O O O O O O O O O
O O O O O O O O O O O O O O O O O O O O O
O O O O O O O O O O O O O O O O O O O O O
a O . O O O O O O O O O O O O O O O . O O
a O O O O O O O O O O O O O O O O O O a a
1 a a a a O O O O O O O O O O O O O O a 1