O O O O O O 8 O O c 0 c O O O 8 O O O O O
O O O O O O O O O c c c O O O O O O O O O
O O . O O O O O O O O O O O O O O O . d O
O d O O O O O O O O O O O O O O d O O O O
d O O O O O O O O O O O O O O O O O O O O
d O O O O O O O O O p O O O O O O O O O O
O O d O O O O O O O O O O O O O O d O O O
O O O O O O O O O O O O O O O O O O O O O
O O . O O O O O O O O O O O O O O O . d O
O O O O O O e O O O O O O O O O O O O O O
3 O O O O O O O O O O O O e O O O O O O 3