0 c 1 c c c c c c c c c O O O O O O O O O
c c c c c c c c c c c O O O O O O O O O O
1 c c c c c c c O O O O O O O O O O . O O
c 1 c c c c c O O O O O O O a O O O O O O
c c c c c c O O O O O O O O O O O O O O O
c c c c c O O O O O O O O O O O O O O O O
c c c c O O O O O O O O O a O O O O O O O
c c c O O O a O O O O O O O O O a O O O O
c c . O O O O O a O O O O O O O O O . O O
O O O O O O O O O O O O O O O a O O O O O
O O O O O O O O O O O O O O O O O O O O 3