a a a a a O O O O O O O O O b O O O O O a
a a a b O 2 O b O O O O O O O O O O O O O
a a a O O O O O O O O O O O O O O 2 . O O
a 6 c O O O O O O O O O O O O O O O O O O
a O c O O O O O O O O O O O O O O O O O O
a O c O O O O O O O O O O O O O O O O O O
a O c O O O O O O O O O O O O O O O O O O
a O c O O O O O b O O O O O O O O O O O O
a a a b O O O O O O O O O O O O O O . O O
a a a a b O 2 O O O O O O O O O O O O O O
a a a a a O O O O O O O O O O b O O O O a