O O O O O O O O O c 0 c O O O O O O O O O
O b O O O 2 O O O c c c O O O O O O O O O
b O . O O O O O O O O O O O O O O O . O O
0 b O O O O O O O O O O O O O O O O O O O
b O O O O O O O O O O O O O O O O O O O O
b O O O O O O O O O P O O O O O O O O O O
O O 2 O O O O O O O O O O O O O O O O O O
O O O O O O O O O O O O O O O O O O O O O
O b . O O O O O O O O O O O O O O O . O O
0 O O O 2 O O O O O O O O O O O O O O O O
O O O O O O O O O O O O O O O O O O O O O