a a O O O 5 O e e e e e O O O O O O O O b
O O O O O O O O O d O O O O O O O O O O O
O O 5 O O O O O O O O O O O O O O O . O O
O O O O O O O O O O O O O O O O O O O O O
O a O O O O O O O O O O O O O O O O O O O
O O O O O O O O O O O O O O O O O O O O O
O O O a O O O O O O O O O O O O O O O O O
O O O O O O O O O O O O O O O O O O O O O
O O . O O O O O O O O O O O O O O a . O O
O 5 O O O O O O O O O O O O O O O O O O O
O O O O O O O O O O O O O O O O O O O O O