a O O O 5 O O O O O O O O O O O O O O c 0
a O O O O O O O O O O O O O O O O O O c c
O O 5 O O O a O O O O O O O O O O O . O O
O O O O O O O O O O O O O O O a O O O O O
5 O O O O O O O O O O O O O O O O O O O O
O O O O O O O O O O O O O O O O O O O O O
O O O O O O b O O O O O O O O O O O O O O
O O O O O O O O O O O O O O O O O O O O O
O O . O O O O O O O O O O O O O O O . O O
e O O O O b O O O O O O O O O O O O O O O
e e O O O O O O O O O O O O O O O O O O O