O O O O O O O O O O O O O O O O O O O O O
O d O O O O O O O O O O O O O O O O O d O
O O . O O O a O O O O O O O 8 O O O . O O
O O O O O O O O O O O O O O O O O O O O O
O O O O O O O O O O O O O O O O O O O O a
O O O O O O O O O O O O O O O O 8 O 3 b b
O O O O O O O O O O O O O O O O O O O O b
O O O O a O O O O O O O O O O O O O O O O
O O . O O O O O O O O O O O 8 O O O . O O
O d O O O O O a O O O O O O O O O O O d O
O O O O O O O O O O O O O O O O O O O O O