O O O O O O O O O O O O O O O O O O O O O
O O O O O O O O O O O O O O O O O O P O O
O O . O O O O O O O O O O O O O O O . O O
O O O O O O O b c c c c c O O O O O O O O
O O O O O O O b c O O O c O O O c O O O O
O O O O O O O b c $ $ $ c O O O c O O O O
O O O O O O O O c O O O c O O O c O O O O
O O O O O O O O c O O O c O O O c O O O O
e O . O O O O O O O O O O O O O O O . O O
e e O O O O O O O O O O O p O O O O O O O
e e e O O O O O O O O O O O O O O O O O O