O O O O O O O O O O O O O O O O O O O O O
O O O O O O O O O O O O O O O O O O O O O
O O . O O O O O O O d O O O O O O O . O O
O O O O d e O O O O O O O O O e d O O O O
O O O O e O O O O O O O O O O O e O O O O
O O O O O O $ O $ O $ O H O h O O O O O O
O O O O O O O O O O O O O O O O O O O O O
O O O O O O O O O O O O O O O O O O O O O
O O . O O O O O O O O O O O O O O O . O O
O O O O O O O O O O O O O O O O O O O O O
O O O O O O O O O O O O O O O O O O O O O