d d d d O O O O O O O O O O O O O O O O O
d d O O O O O O O O O O O O O O O O O O O
O 4 . O O O O e O O O O O O O O O O . O O
O O O O O O O O O O O O O O O O O O O O O
e e e O O O O O O O O O O O O O O O O O O
e e e 3 O O O O O O p O O O O O O O O O O
4 O O O O O O O O O O O O O O O O O O O O
O O O O O O O O O O O O O O O O O O O O O
O 4 . O O O O O O O O O O O O O O O . O O
d d O O O O d O O O O O O O O O O O O O O
d d d O O O O O O O O O O O O O O O O O O