d d d O O O O O O O O O O O O O O O d d d
d d O O O O O O O O O O O O O O O O O d d
d O . O O O O O O O O O O O O O O O . O d
O O O O O O O O 1 O e O 1 O O O O O O O O
O O O O O O O O O e e e O O O O O O O O O
O O O O O O O O e e e e e O O O O O O O O
O O O O O O O O O e e e O O O O O O O O O
O O O O O O O O 1 O e O 1 O O O O O O O O
d O . O O O O O O O O O O O O O O O . O d
d d O O O O O O O O O O O O O O O O O d d
d d d O O O O O O O O O O O O O O O d d d