a a a a O O O 5 O O O O O O O O O O O O O
a a a b O O O O O O O O O O O O O O O O O
a a 5 O O O O O O O O O O O O O O O . O O
a O O O O O O O O O O O O O O O O O O O O
1 O O O O O O O O O O O O O O O O O O O O
O O b O O O O O O O O O O O O O O O O O O
5 O O O O O O O O O O O O O O O O O O O O
O O O O O O O O O O O O O O O O O O O O O
O O . O O O O O O O O O O O O O O O . O O
a O 5 O O O O O O O O O O O O O O O O O O
a a O O O O O O O O O O O O O O O O O O O