O O O O O O O O O O O O O O 3 O O O O O O
O O O 1 O O O O O O O O O O O O O O O O O
O e . O O O O O O O O O O O O O O O . O O
e O e O O O O O O O O O O O O O O O O O O
e O O 8 O O O O O O O O O O O O O O O O O
O O O O O O O O O O O O O O O O O O O O O
O O O O O O O O O O O O O O O O O O O O O
O 8 O d O O O O O O O O O O O O O O O O O
O d . O O O O O O O O O O O O O O O . O O
O O e O O O O O O O O O O O O O O O O O O
e O e O O O O O O O O O O 3 O O O O O O O