O O O O O O O O O O O O O O O O O O O O O
O O O O O O O O O O O O O O O O O O O O O
O O . O O O O O O O O O O O O O O O . O O
O O O O O O O O 1 O c O 1 O O O O O O O O
O O O O O O O O O c O c O O O O O O O O O
O O O e O O O O c O 9 O c O O O O e O O O
O O O O O O O O O c O c O O O O O O O O O
O O O O O O O O 1 O c O 1 O O O O O O O O
O O . O O O O O O O O O O O O O O O . O O
O O O O O O O O O O O O O O O O O O O O O
O O O O O O O O O O O O O O O O O O O O O