O O O O O O O O O O O O O O O O O O O O O
O O O O O O O O O O O O O O O O O O O O O
O O . O O O e O O O O O O e O O O d . O O
O O d O O O O O O O O O O O O O O O O O O
O O O O O O O O O 3 O O O O O O O O O O O
O O O O O O O O 3 3 3 O O O O O O O O O O
O O O d O O O O O 3 O O O O O O d O O O O
O O O O O O O O O O O O O O O O O O O O O
O O . O O d O O O O d O O O O O O O . O O
O O O O O O O O O O O O O e O O e O O O O
O O O O O O O O O O O O O O O O O O O O O