O O O O O O O O O O O O O O O O O O O O O
O 1 O O O O O O O O O O O O O O O O 1 O O
e e e e e O O O O O O O O O O O O O . O O
O O O O O e e e e e e e e e e e e O e e e
e O e O O O O O O O O O O O O O O O O O O
O O O e O O O O O O 1 O O O O O O O O O O
O O O O e e e e e e e e e e O O O e e e e
e e O O O O O O O O O O O O e e e O O O O
O e e e e O O O O O O O O O O O O O . O O
1 O O O O e e e O e e e e e e O O O 1 O O
O O O O O O O O O O O O O O O e O O O O O