a O O O O O O O O O O O O O O O a a a a a
O O O O b O O O O 2 O O O O O O b a a a a
O O . O O O O O O O O O O O O O O a a a a
O O O O O O O O O O O O O O O O O O c 6 a
O O O O O O O O O O O O O O O O O O c O a
O O O O O O O O O O O O O O O O O O c O a
O O O O O O O O O O O O O O O O O O c O a
O O O O O O O O O O O O O O O O O O c O a
O O . O O O O O O O O O O O O O O b a a a
O O O b O 2 O O O O O O 2 O O O b a a a a
a O O O O O O b O O O O O O O O a a a a a