O O O O O O O O O O O O O O O O O O e e e
O O O O O O O O O O O O O O O O O O c 0 e
O O . O O e O O O O O O O O O O O O c O e
O O O O O O O O e O O O O e O O O O c 1 e
O O e O O O O O O O O O O O O O O O c O e
O O O O O O O O O O O O O O O O O O c 0 e
O O O O O O O O O O O O O O O O O O c O e
O O O e O O O O O O O e O O O O O O c 1 e
d O . O O O O O O e O O O O O O O O c O e
d d d O O e O O O O O O O O O O O O c 0 e
d d d O O O O O O O O O O O O O O O e e e