8 O O O O O O O O O O O O O O O O O O O O
O O O O O O O O O O O O O O O O O O O O O
O O . O O O O O O O O O O O O O O O . O O
O O a O O O a O O O O O O O a O O O O O O
O O O O O O O O O O O O O O O O O O O c c
O O O a O O O O O O O O a O O O O O c c c
O O O O O O O O O a O O O O O O O c c c c
O O O O O O O O O O O O O O O O c c c c c
O O . O O a O O O O O O O c c c c c c c c
O O O O O O O O O O O c c c c c c c c c 1
O O O O O O O O O O c c c c c c c c c 1 0