e e e O O O O O O O O O O O O O O c O O 0
e d O O O O O O O O O O O O O O O O c O O
O O . O O O O O O O O O O O O O O O . c O
O O O O O O O O O 3 O O O O O O O O O O c
O O O O O O O O O O O O O O O O O O O O O
O O O O O O O O O O O O O O O O O O O O O
O O O O O O O O O 3 O O O O O O O O O O O
c O O O O O O O O O O O O O O O O O O O O
O c . O O O O O O O O O O O O O O O . O O
O O c O O O O O O O O O O O O O O O O d e
0 O O c O O O O O O O O O O O O O O e e e