O O O O O O O e O 0 O 0 e O O O O O O O O
O O O O O O O O c c c c O O O O O O O O O
O O . O O O O O O O O O O O O O O O . O O
O O O O O O O c O O O O O c O O O O O O O
O O O O O O O O O O O O O O O O O O O O O
O O O O O O O e O O 9 O O e O O O O O O O
O O O O O O O O O O O O O O O O O O O O O
O O O O O O O O O O O O O O O O O O O O O
O O . O O O O O O O O O O O O O O O . O O
d O O O O O O O O O O O O O O O O O O O d
d d O O O O O O O O O O O O O O O O O d d