O O O O O O O a a a a a b O O O O O O O O
O O O O O O O O a b a O b O O O O O O O O
O O . O O O O O O 8 O 2 O O O O O O . O O
O O O O O O O O O O O O O O O O O O O O O
O O O O O O O O O O O O O O O O O O O O O
O O O O O O O O O O O O O O O O O O O O O
O O O O O O O O O O O O O O O O O O O O O
O O b O O O O O O O O O O O O O O O O O O
O O . O O 2 O O O O O O O O O O 2 O a O O
O O b b O O O O O O O O O O O O O b a O O
O O O O O O O O O O O O O O O O O O O O O