O O O O O O O O 4 O 4 O 4 O O O O O O O O
O O O O O O O O O 4 O 4 O O O O O O O O O
O O . d O O O O O O O O O O O O O O . O O
O O O O O O O O O O O O O O O O d O O O O
O O O O O O O O O O O O O O O O O O O O O
O O O O O O O O O O p O O O d O O O O O O
O O O O O O O O O O O O O O O O O O O O O
O O O O d O O O O O O O O O O O O O O O O
O O . O O O O O O O O O d O O O O O . O O
O d O O O O O O O O O O O O O O O d O O O
O O O O O O O O O O O O O O O O O O O O O