O O O O O O O O O e 0 e O O O O O O O O O
O c c c O O O O O e O e O O O O O c c c O
O c 9 c O O O O O O O O O O O O O c 9 c O
e c c c O O O O O e O e O O O O O c c c e
O O O O a c c c c e O e c c c c a O O O O
O O O O O O O O O O p O O O O O O O O O O
O O O O O O O O O O O O O O O O O O O O O
O O O O O O O O O O O O O O O O O O O O O
O O d O O O O O O O O O O O O O O O d O O
O O O O O O O O O O O O O O O O O O O O O
O O O O O O O O O O O O O O O O O O O O O