O O O O O O O O O a 1 a O O O O O O O a a
O O O O O O O O O O a O O O O O O O O O a
O O . O a O O O O O O O O O O O O O . O O
O O O O O O O O O O O O O O O O a O O O O
O O O O O O O O O O 2 O O O O O O O O O O
O O O O O O O O O 2 b 2 O O O O O O O O O
O O O O O O O O O O 2 O O O O O O O O O O
O O a O O O O O O O O O O O a O O O O O O
O O . O O O O O O O O O O O O O O O . O O
O O O O O O a O O O O O O O O O O O O O O
O O O O O O O O O O O O O O O O O O O O O