O O O O O O O O O O O O O O O O O O O O O
O O O O O O O O O O O O O O O O O O O O O
O O . O O O O O a O O O O O O O O O . O O
O O O O O O O O O O O O O O O O O O O O O
O O a O O O a O O O O O O a O O O O O O O
O O O O O O O O O 3 O O O O O O O O O O O
O O O O O O O O O O O O O a O O O O O O O
O O O O O O O O O O O O O O O O O O O O O
O O . a O O O O O O O O O O O O O a . O O
O O O O O O O O O c c c O O O O O O O O O
O O O O O O 1 O O c 9 c O O 1 O O O O O O