O O O O O O O O O a O a O O O O O O O O O
O O O O O O O 0 O a O a O O O O O O O 0 O
O O . O O O O O O a O O O O O O O O . O O
O O O O O O O O a a O a a O O O O O O O O
a a O a a a a a a O O O a a a a a a a a a
O O O O O O O O O O O O O O O O O O O O O
a a a a a a a a a O O O a a a a a a O a a
O O O O O O O O a a O a a O O O O O O O O
O 0 . O O O O O O O O a O O O O O O . O O
O O O O O O O O O a O a O 0 O O O O O O O
O O O O O O O O O a O a O O O O O O O O O