O O O O O O O O O O O O O O O O O O O O O
O O O O O O O O O O O O O O O O O O O O O
O O . O O O O O O O O O O O O O O O . O O
O O O O O O O O 1 O O O O b O O O O O O O
O O O O O a O O O O O O O O O O O O O O O
O O O O O O O O O O 1 O O O O O O O O O O
O O O O O 1 O O O O O O O O O O O O O O O
O O O O O O O O O O O O O 1 O O O O O O O
O O . O O O O O O O 7 O e O O O O O . O O
O O O O O O O O O e d e e O O b O O O O O
O O O O O O O O d d d d e e O O O O O O O