0 O O O O O O O O O O O O O O O O O O O 0
O O O O O O O O O O 1 O O O O O O O O O O
O O . O a O O O O O O O O O O O a O . O O
O O O O O a a a a a a a a a a a O O O O O
O O O O O O O O O O O O O O O O O O O O O
O O O O O O O O O O P O O O O O O O O O O
O O O O O O O O O O O O O O O O O O O O O
O O O O O a a a a a a a a a a a O O O O O
O O . O a O O O O O O O O O O O a O . O O
O O O O O O O O O O 1 O O O O O O O O O O
0 O O O O O O O O O O O O O O O O O O O 0