O O O e O O e O O O O O O e O O O O O e O
O O 0 O O O e O O O O O O e O O O O O e O
O O . e O O O e O O O O O O O 0 O O e O O
O O O e O O O e O O O O O O O O O O e O O
O O O e O O O e O O O O O e O O O e O O O
. O O e O O O e O O O O O e O O O e O O O
O O O e O O O e O O O O O e O O O e O O O
O O e O O O O O O O O O O e O O O e O O O
O O e O O O 0 O O O O O O e O O O e . O O
O e O O O O O e O O O O O O e O O O 0 O O
O e O O O O O e O O O O O O e O O e O O O