O O O O O O O O O O O O O O O O O O O O O
O O O O O O O O O O 5 O O O O O O O O O O
O O . O O O O O O O O O O O O O O O . O O
O O O O d O O O O O 6 O O O O O d O O O O
O O O O O d O O O O O O O O O d O O O O O
O O O O O O O O O O p O O O O O O O O O O
O O O O O d O O O O O O O O O d O O O O O
O O O O d O O O O O O O O O O O d O O O O
O O . O O O O O O O O O O O O O O O . O O
O O O O O O O O O O 5 O O O O O O O O O O
O O O O O O O O O O O O O O O O O O O O O