a a O O O O c c O O 0 O O c c O O O O O O
a O O O O O O O c O O O c O O O O O O O O
O O . O O O O O O c c c O O O O O O . O O
O O O O O O O O O O O O O O O O O O O O O
O O O O O O O O O O O O O O O O O O O O O
O O O O O O O O O O 9 O O O O O O O O O O
O O O O O O O O O O O O O O O O O O O O O
O O O O O O O O O O O O O O O O O O O O O
O O . O O O O O O c c c O O O O O O . O O
O O O O O O O O c O O O c O O O O O O O e
O O O O O O c c O O 0 O O c c O O O O a a