b b O O O O O O O O O O O O O O O O O O a
b O O O O O O O O O O O O O O O O O O O O
O O 7 O O O O O O O O O O O O O O O . O O
O O O O O O O O O 2 O O O O O O O O O O O
O O O O O O O O O O O O O O O O O O O O O
O O O O O O O O O 2 O O O O O O O O O O O
O O O O O O O O O O O O O O O O O O O O O
O O O O O O O O O 2 O O O O O O O O O O O
O O . O O O O O O O O O O O O O O O . O O
O O O O O O O O O O O O O O O O O O O O a
b O O O O O O O O O O O O O O O O O O b a