O O O O O O O O O O O O O O O O O O O O O
O O O O O O O O O O O O O O O O O O O O O
O 1 . O O d O O O O O O O O O O O O . O O
e d O O O O O O O O e O O O O O O O O O O
e e O O O O O O O O O O O d O O O O O O O
e e d O O O O 9 O O O O O O O O O O O O O
e e d O O d O O O O O d O O O O O O O O O
e e O O O O 8 O O O O O O O O O O O O O O
e 1 . O O O d O O O O O O O O O O O . O O
O O O O O O O O O d O O O O O O O O O O O
O O O d O O O O O O O O O O O O O O O O O