9 9 9 9 9 9 9 9 9 9 9 9 9 9 9 9 9 9 9 9 9
9 9 9 9 9 9 b b 9 9 9 9 9 9 9 9 9 9 9 9 1
9 9 9 0 9 9 9 9 9 9 9 9 9 9 9 9 9 9 9 9 9
9 9 9 9 9 9 9 b 9 9 9 9 9 9 9 9 9 9 9 9 9
9 9 9 9 9 9 9 b 9 9 9 9 9 0 9 9 a 9 9 9 9
9 9 9 9 9 9 9 b 9 9 9 9 9 9 9 9 a 9 9 9 9
9 9 9 9 9 9 9 9 9 9 9 9 9 9 9 9 a 9 9 9 9
9 9 9 9 9 9 9 9 9 9 9 9 9 9 9 9 a 9 9 9 9
b 9 9 9 9 9 9 9 9 9 9 9 9 9 9 9 9 0 9 9 9
b b 9 9 0 9 9 9 9 9 9 9 9 9 9 9 9 9 9 9 9
b b b 9 9 9 9 9 9 9 9 9 9 9 9 9 9 9 9 9 9