9 9 9 9 9 9 9 9 9 9 9 9 9 9 9 9 9 9 9 9 9
9 9 9 9 9 9 b b 9 9 9 9 9 9 9 9 9 9 9 9 9
9 9 9 9 9 9 9 9 9 9 9 9 9 9 9 9 9 9 9 9 9
9 9 9 9 9 9 9 b c c c c c 9 9 9 9 9 9 9 9
9 9 9 9 9 9 9 b c 9 9 9 c 9 9 9 c 9 9 9 9
9 9 9 9 9 9 9 b c 9 A 9 c 9 9 9 c 9 9 9 9
9 9 9 9 9 9 9 9 c 9 9 9 c 9 9 9 c 9 9 9 9
9 9 9 9 9 9 9 9 c c c c c 9 9 9 c 9 9 9 9
b 9 9 9 9 9 9 9 9 9 9 9 9 9 9 9 9 9 9 9 9
b b 9 9 9 9 9 9 9 9 9 9 9 9 9 9 9 9 9 9 9
b b b 9 9 9 9 9 9 9 9 9 9 9 9 9 9 9 9 9 9