e e e O O O O O O O O O O O O O O O O O O
e e O O O O O O O O O O O O O O O O O e O
e O . O O O O O O O O O O O O O O O . O O
O O O O O O O O c O O O c O O O O O O O O
O O O O O O O O O O O O O O O O O O O O O
O O O O O O O O O O O O O O O O O O O O O
O O O O O O O O O O O O O O O O O O O O O
O O O O O O O O c O O O c O O O O O O O O
O O . O O O O O O O O O O O O O O O . O O
O d O O O O O O O O O O O O O O O O O O d
O O O O O O O O O O O O O O O O O O O d d