O O O O O O O O O O O O O O O O O O O O O
O O O 0 O O d d O O O O O O O O O O O O O
O O . O O O O O O O O O O O O 6 O O . O O
O O O O O O O b c c c c c O O O O O O O O
O 8 O O O O O b c O O O c O O O c O O O O
O O O O 7 O O b c O 9 O c O O O c O O O O
O O O O O O O O c O O O c O O O c O O O O
O O O O O O O O c c c c c O O O c O O O O
e O . O O O O O O O O O O O O O O O . O O
e e O O O O O O O O O O O O O O O O O O O
e e e O O O O O O O O O O O O O O O O O O