O O O O O O O O O O O O O O O O O O O O O
O d O O O O O O O O O O O c c c O O O d O
O O . O O O a O O O O O O O O O O O . O O
O O e e O O O O O O O O O O O O O O O O O
O O e O O O O O O O O O O O O O O O O O O
O O O O O O O O O O O O O O O O O O O O O
O O O O O O O O O O O O O O O O O O O O O
O O O O a O O O O O O O O O O O O O O O O
O O . O O O O O O O O O O O O O O O . O O
O d O O b b b a O O O O O O O O O O O d O
O O O O O O O O O O O O O O O O O O O O O