O 3 O O O O O O O O O O O e e e e e e e e
O O O O O O O O O O O 4 O e e e e e e e e
O O . O O O O d O O O O O O e e e e e e e
O O O O O O O O O O O O O O O O e e e e e
O O O O O O O O O O O O O O O O O O e e e
O O O O O O O O O O O O O O O O O O O e e
O O O O O O O O O O O O O O O O O O O O e
O d O O O O O O O O O O O O O O O 4 O O O
d O . d O O O O O O O O O O d O O O . O O
O O O O O O O O O O O O O O O O O O O O O
O d O O O d O O O O O O O O O O 3 O O O O