O O O O O O O O 2 O O O O O O O O O O O 1
O O O O O O O O O O O O 2 O O O O O O O O
O O e e O O O O O O O O O O O O O d a a O
O O O O O O O O O O O O O O O O O c 6 a O
O O O O O O O O O O 3 O O O O O O c O a O
O O O O O O O O O O P O O O O O O c O a O
O O O O O O O O O O O O O O O O O c O a O
O O O O O O O O O O O O O O O O O c O a O
O O . b O O O O O O O O O O O O O d a a O
O O O O e O O O O O O O O O O O O O O O O
O O O O O O O d O O O O O O O O O O O O 1