O O O O O O O O O O O O O O O O O O O O O
O O O O O O O O O O O O O O O O O O O O O
O O . O O O O O O O O O O O O O O O . O O
O O O O O O O O O O O O O O O O O O O O O
O O 5 O O e O O O O O O O O O O O O O O O
O O O O O O O O O O O O O O e O O O O O O
O 5 O O O O O O O O O O O O O O O O O O O
O O O O O O O O d O O O O O O O O O O O O
O O 7 O O O O O O O O O O O O O O O . O O
O O O O O O 5 O O O O O O O O O O O O O O
d O O O O O O O O 5 O O O d O O O O O O O