a a a a a O O O O O O O O O O O O O O O O
a a a b O O O O O O O O O O O O O O O O O
a a c O 2 O O O O O O O O O O O O O . O O
O 6 c O O O b O O O O O O O O O O O O O O
O O c O O O O O O O O O O O O O O O O O O
O O c O O O O O O O O O O O O O O O O O O
O O c O O O O O O O b O O O O O O O O O O
O O c O 2 O O O O O O O O O O O O O O O O
a a c O O O O a O O O O O O O O O O . O O
a a a a O O 2 O O O b O O O O O O O O O O
a a a b a O O O O O O O O O O O O O O O O