O O O O O O O O O O O O O O O O O O O O O
O O O O O O O O O O O O O O O O O O O O O
O O . e O O O O O O O O O O O O b O . O O
O O O O O O O O O O O O O O O O O O O O O
O O O O O O O O O c c O O O O O O O O O O
O 4 O O O O e O O c c O O O O O O O O O O
O O O O O O O O O O O O O O O O O O O O O
O O O O O 5 O O O O O O O O O O O O O O O
e O . O O O O O O O O O O O O O O O . O O
e d d 4 O O O O O O O O O O O O O O O O O
e 1 c O O d d O O O O O O O O O O O a O O